1 1 1 1 1 1 1 1 1 
2 0 0 0 3 0 0 0 3
2 0 0 0 0 0 0 0 3
2 0 0 0 0 0 0 0 3
2 1 0 0 0 0 0 4 3
2 0 0 0 0 0 0 0 3
2 0 0 0 0 0 0 0 3
2 0 0 0 2 0 0 0 3
4 4 4 4 4 4 4 4 4